time,execute,finalize,initial,initialize,subdomain,threadjoin,timestep
0,4,1,1,1,2,0,0
0.1,12,3,1,3,6,0,1
0.2,20,5,1,5,10,0,2
0.3,28,7,1,7,14,0,3
0.4,36,9,1,9,18,0,4
0.5,44,11,1,11,22,0,5
0.6,52,13,1,13,26,0,6
0.7,60,15,1,15,30,0,7
0.8,68,17,1,17,34,0,8
0.9,76,19,1,19,38,0,9
1,84,21,1,21,42,0,10

