time,execute,finalize,initial,initialize,subdomain,threadjoin,timestep
0,2,1,1,1,0,0,0
0.1,6,3,1,3,0,0,1
0.2,10,5,1,5,0,0,2
0.3,14,7,1,7,0,0,3
0.4,18,9,1,9,0,0,4
0.5,22,11,1,11,0,0,5
0.6,26,13,1,13,0,0,6
0.7,30,15,1,15,0,0,7
0.8,34,17,1,17,0,0,8
0.9,38,19,1,19,0,0,9
1,42,21,1,21,0,0,10

